ability (n) - способность
able (adj) - способный
about (adv & prep) - о
above (adj, adv & prep) - выше
abroad (adv) - за границей
absent (adj) - отсутствует
absolutely (adv) - абсолютно
accent (n) - акцент
accept (v) - принять
acceptable (adj) - приемлемый
access (n) - доступ
accident (n) - несчастный случай
accommodation (n) - размещение
accompany (v) - сопровождать
according to (prep phr) - согласно
account (n) - счет
accident (n) - несчастный случай
accountant (n) - бухгалтер
accurate (adj) - точный
ache (n) - боль
achieve (v) - достичь
achievement (n) - достижение
across (adv & prep) - поперек
act (n & v) - действовать
action (n) - действие
active (adj) - активный
activity (n) - деятельность
actor (n) - актер
actress (n) - актриса
actually (adv) - на самом деле
advertisement (n) - реклама
add (v) - добавить
addition (n) - дополнение
address (n) - адрес
admire (v) - восхищаться
admission (n) - прием
admit (v) - признать
adult (adj & n) - взрослый
advance (n) - заранее
advanced (adj) - продвинутый
advantage (n) - преимущество
adventure (n) - приключение
advert (n) - реклама
advertise (v) - рекламировать
advertisement (n) - реклама
advice (n) - совет
advise (v) - советовать
aeroplane (n) - самолет
affect (v) - влиять
afford (v) - позволить себе
afraid (adj) - боюсь
after (adv, conj & prep) - после
afternoon (n) - полдень
afterwards (adv) - потом
again (adv) - снова
against (prep) - против
age (n) - возраст
aged (adj) - постаревший
agency (n) - агентство
ages (n pl) - возраст
ago (adv) - назад
agree (v) - согласен
ahead (adv) - впереди
aim (n & v) - цель
air (n) - воздух
air conditioning (n) - кондиционер
air force (n) - военно-воздушные силы
airline (n) - авиакомпания
airport (n) - аэропорт
alarm (n) - сигнализация
alarm clock (n) - будильник
album (n) - альбом
alike (adv) - одинаково
alive (adj) - живой
all (adj, adv, det & pron) - все
all right (adj, adv & exclam) - все в порядке
allow (v) - разрешить
almost (adv) - почти
alone (adv & adj)    - один
along (adv & prep) - вдоль
aloud (adv) - вслух
alphabet (n) - алфавит
already (adv) - уже
also (adv) - также
although (conj) - хотя
altogether (adv) - вообще
always (adv) - всегда
amazed (adj) - пораженный
amazing (adj) - потрясающий
ambition (n) - амбиции
ambulance (n) - скорая помощь
among (prep) - среди
amount (n) - сумма
amusing (adj) - забавный
ancient (adj) - древний
and (conj) - и
angry (adj) - сердитый
animal (n) - животное
ankle (n) - лодыжка
anniversary (n) - годовщина
announce (v) - объявить
announcement (n) - объявление
annoy (v) - раздражать
annual (adj) - ежегодный
another (det & pron) - другой
answer (n & v) - ответ
answerphone (n) - автоответчик
ant (n) - муравей
antique (adj & n) - античный
anxious (adj) - тревожный
any (det & pron) - любой
anybody (pron) - кто-нибудь
anymore (adv) - больше
anyone (pron) - кто-нибудь
anything (pron) - что-нибудь
anyway (adv) - в любом случае
anywhere (adv) - где угодно
apart (adv) - отдельно
apart from (adv) - кроме
apartment (n) - квартира
apartment building (n) - многоквартирный дом
apologise (v) - извиниться
apology (n) - извинение
app (n) - приложение
appear (v) - появиться
appearance (n) - внешний вид
apple (n) - яблоко
application (n) - приложение
apply (v) - применить
appointment (n) - назначение
approach (v) - подход
approve (v) - одобрять
approximately (adv) - примерно
architect (n) - архитектор



architecture (n) - архитектура
area (n) - площадь
argue (v) - спорить
argument (n) - аргумент
arm (n) - рука
armchair (n) - кресло
army (n) - армия
around (adv & prep) - вокруг
arrange (v) - устроить
arrangement (n) - расположение
arrest (v) - арест
arrival (n) - прибытие
arrive (v) - приехать
art (n) - искусство
article (n) - артикль
artist (n) - художник
as (conj & prep) - как
ashamed (adj) - стыдно
ask (v) - спросить
asleep (adj) - спящий
as long as (phr) - до тех пор, пока
aspirin (n) - аспирин
assist (v) - помогать
assistant (n) - помощник
astronaut (n) - космонавт
as well as (prep & adv) - а также
at (prep) - в
at all (prep phr) - вообще
at first (prep phr) - сначала
athlete (n) - спортсмен
athletics (n) - легкая атлетика
at last (prep phr) - наконец
at least (prep phr) - по крайней мере
atmosphere (n) - атмосфера
at once (prep phr) - сразу
at present (prep phr) - в настоящее время
attach (v) - прикрепить
attack (n & v) - атака
attempt (v) - попытка
attend (v) - присутствовать
attention (n) - внимание
at the same time (prep phr) - в то же время
attitude (n) - отношение
attract (v) - привлекать
attraction (n) - притяжение
attractive (adj) - привлекательный
audience (n) - аудитория
aunt (n) - тётя
author (n) - автор
autumn (n) - осень
available (adj) - доступный
average (adj & n) - средний
avoid (v) - избегать
awake (adj) - проснуться
away (adv) - прочь
awesome (adj) - потрясающий
awful (adj) - ужасный
baby (n) - детка
babysit (v) - присмотр за детьми
babysitter (n) - няня
back (adv, adj & n) - назад
background (n) - фон
background (n) - фон
backpack (n) - рюкзак
backpacker (n) - турист
backpacking (n) - пеший туризм
backwards (adv) - назад
bad (adj) - плохой
badly (adv) - плохо
badminton (n) - бадминтон
bag (n) - сумка
baggage (n) - багаж
bake (v) - запекать
baker (n) - пекарь
balcony (n) - балкон
bald (adj) - лысый
ball (n) - мяч
ballet (n) - балет
balloon (n) - воздушный шар
banana (n) - банан
band (n) - группа
bandage (n) - повязка
bank (n) - банк
bank account (n) - банковский счет
banking (n) - банковское дело
bar (n) - бар
barbecue (n & v) - барбекю
barber (n) - парикмахер
baseball (n) - бейсбол
base on (phr v) - основа на
basic (adj) - основной
basin (n) - бассейн
basket (n) - корзина
basketball (n) - баскетбол
bat (n) - летучая мышь
bath (n & v) - ванна
bathing suit (n) - купальный костюм
bathroom (n) - ванная комната
bathtub (n) - ванна
battery (n) - батарея
battle (n) - битва
bay (n) - залив
be (av & v) - быть
beach (n) - пляж
bean (n) - боб
bear (n) - медведь
beard (n) - борода
beat (v) - бить
beautiful (adj) - красивый
beauty (n) - красота
because (conj) - потому что
because of (prep phr) - из-за
become (v) - стать
bed (n) - кровать
bedroom (n) - спальня
bee (n) -
beef (n) - говядина
before (prep, adv & conj) - до
begin (v) - начать
beginner (n) - новичок
beginning (n) - начало
behave (v) - вести себя
behaviour (n) - поведение
behind (prep & adv) - позади
believe (v) - верить
bell (n) - колокольчик
belong (v) - принадлежать
below (adv & prep) - ниже
belt (n) - ремень
beneath (prep) - внизу
benefit (n & v) - выгода
be over (phr v) - закончиться
beside (adv & prep) - рядом
besides (prep) - кроме того
best (adj & adv) - лучший
bestseller (n) - бестселлер
better (adj & adv) - лучше
between (prep & adv) - между
beyond (prep & adv) - за пределами
bicycle (n) - велосипед
big (adj) - большой
bike (n) - велосипед
bill (n) - счет
bin (n) - мусорное ведро
biography (n) - биография
biology (n) - биология
bird (n) - птица
birth (n) - рождение
birthday (n) - день рождения
biscuit (n) - бисквит
bit (n) - бит
bite (v) - укусить
bitter (adj) - горький
black (adj & n) - черный
blackboard (n) - доска
blame (v) - винить
blank (adj) - пустой
blanket (n) - одеяло
bleed (v) - кровоточить
blind (adj) - слепой
block (n) - блок
blog (n) - блог
blogger (n) - блоггер
blond (adj) - блондин
blood (n) - кровь
blouse (n) - блузка
blow (v) - удар
blue (adj & n) - синий
board (n & v) - доска
board game (n) - настольная игра
boarding pass (n) - посадочный талон
boat (n) - лодка
body (n) - тело
boil (v) - кипятить
boiled (adj) - вареный
bold (adj) - жирный
bomb (n & v) - бомба
bone (n) - кость
book (n & v) - книга
bookcase (n) - книжный шкаф
booking (n) - бронирование
booking office (n) - касса
bookshelf (n) - книжная полка
bookshop (n) - книжный магазин
bookstore (n) - книжный магазин
boot (n) - ботинок
border (n) - граница
bored (adj) - скучно
boring (adj) - скучный
born (adj) - рожденный
borrow (v) - брать взаймы
boss (n) - босс
both (pron & det) - оба
bother (v) - беспокоить
bottle (n) - бутылка
bottom (adj & n) - нижний
bowl (n) - чаша
box (n) - коробка
boy (n) - мальчик
boyfriend (n) - парень
bracelet (n) - браслет
brain (n) - мозг
brake (n & v) - тормоз
branch (n) - филиал
brand new (adj) - совершенно новый
brave (adj) - храбрый
bread (n) - хлеб
break (n & v) - перерыв
break down (phr v) - сломаться
breakfast (n) - завтрак
break in (phr v) - ворваться
break up (phr v) - расстаться
breath (n) - дыхание
breathe (v) - дышать
breeze (n) - ветерок
bride (n) - невеста
bridge (n) - мост
brief (adj) - краткий
bright (adj) - яркий
brilliant (adj) - блестящий
bring (v) - принести
bring up (phr v) - воспитывать
broad (adj) - широкий
broccoli (n) - брокколи
brochure (n) - брошюра
broken (adj) - сломанный
brother (n) - брат
brown (adj & n) - коричневый
brush (n & v) - кисть
bucket (n) - ведро
bug (n) - ошибка
build (v) - построить
building (n) - здание
bulb (n) - лампочка
bunch (n) - пучок
burger (n) - бургер
burn (v) - сжечь
burning (adj) - горящий
bury (v) - закопать
bus (n) - автобус
business (n) - дело
businessman (n) - бизнесмен
businesswoman (n) - деловая женщина
bus station (n) - автовокзал
bus stop (n) - автобусная остановка
busy (adj) - занят
but (conj & prep) - но
butcher (n) - мясник
butter (n) - сливочное масло
butterfly (n) - бабочка
button (n) - кнопка
buy (v) - купить
buyer (n) - покупатель
by (prep) - автор
by accident (prep phr) - случайно
by hand (prep phr) - вручную
by mistake (prep phr) - по ошибке
by name (prep phr) - по имени
bye (exclam) - пока
cab (n) - такси
cabbage (n) - капуста
cabin (n) - каюта
cabinet (n) - шкаф
cable (n) - кабель
café/cafe (n) - кафе/кафе
cafeteria (n) - кафетерий
cage (n) - клетка
cake (n) - торт
calculator (n) - калькулятор
calendar (n) - календарь
calf (n) - теленок
call (n & v) - позвонить
call for (phr v) - призывать
call in (phr v) - позвони
calm (adj) - спокойный
camel (n) - верблюд
camera (n) - камера
camp (n & v) - лагерь
camping (n) - кемпинг
campsite (n) - кемпинг
can (n & mv) - может
canal (n) - канал
cancel (v) - отменить
candidate (n) - кандидат
candle (n) - свеча
candy (n) - конфета
canteen (n) - столовая
cap (n) - колпачок
capital (adj & n) - капитал
captain (n) - капитан
car (n) - машина
card (n) - карточка
cardboard (adj & n) - картон
care (n & v) - уход
something (v) - что-то
career (n) - карьера
careful (adj) - осторожный
carefully (ad) - осторожно
careless (adj) - неосторожный
car park (n) - автостоянка
carpet (n) - ковер
carrot (n) - морковь
carry (v) - нести
carry on (phr v) - продолжай
carry out (phr v) - выполнять
cartoon (n) - мультфильм
case (n) - случай
cash (n) - наличные
cashpoint (n) - банкомат
castle (n) - замок
casual (adj) - случайный
cat (n) - кот
catch (v) - поймать
cathedral (n) - собор
cattle (n) - крупный рогатый скот
cave (n) - пещера
CD (n) - компакт-диск
CD player (n) - CD-проигрыватель
ceiling (n) - потолок
celebrate (v) - праздновать
celebration (n) - праздник
celebrity (n) - знаменитость
cell phone (n) - сотовый телефон
cent (n) - цент
centimetre (n) - сантиметр
central (adj) - центральный
central heating (n) - центральное отопление
centre/center (n) - центр/центр
century (n) - век
cereal (n) - хлопья
ceremony (n) - церемония
certain (adj) - определенный
certainly (adv) - конечно
certificate (n) - сертификат
chain (n) - цепочка
chair (n) - стул
challenge (n & v) - вызов
challenging (adj) - вызывающий
champion (n) - чемпион
championship (n) - чемпионат
chance (n) - шанс
change (n & v) - изменить
changing room (n) - раздевалка
channel (n) - канал
chapter (n) - глава
character (n) - персонаж
charge (n & v) - заряд
charity (n) - благотворительность
charming (adj) - очаровательный
chat (n & v) - чат
chatroom (n) - чат
chat show (n) - ток-шоу
cheap (adj) - дешевый
cheat (v) - обмануть
check (n & v) - проверить
check in (phr v) - зарегистрироваться
check-in (n) - регистрация
check out (phr v) - выезд
checkout (n) - касса
cheek (n) - щека
cheerful (adj) - веселый
cheers! (exclam) - ваше здоровье
cheese (n) - сыр
chef (n) - повар
chemist (n) - химик
chemistry (n) - химия
cheque (n) - проверить
chess (n) - шахматы
chest of drawers (n) - комод
chicken (n) - курица
child (n) - ребенок
childhood (n) - детство
chilli (n) - перец чили
chin (n) - подбородок
chip (n) - чип
chocolate (n) - шоколад
choice (n) - выбор
choose (v) - выбрать
cinema (n) - кино
circle (n) - круг
circus (n) - цирк
city (n) - город
clap (v) - хлопать
class (n) - класс
classical (adj) - классический
classmate (n) - одноклассник
classroom (n) - класс
clean (adj & v) - чистый
cleaner (n) - уборщик
clear (adj & v) - ясно
clearly (adv) - ясно
clever (adj) - умный
click (n & v) - щелкните
cliff (n) - скала
climate (n) - климат
climb (v) - подняться
climbing (n) - восхождение
clinic (n) - клиника
clock (n) - часы
close (adj, adv & v) - закрыть
closed (adj) - закрытый
clothes (n pl) - одежда
cloud (n) - облако
cloudy (adj) - пасмурно
clown (n) - клоун
club (n) - клуб
coach (n) - тренер
coast (n) - побережье
coat (n) - пальто
coconut (n) - кокос
cod (n) - треска
coffee (n) - кофе
coin (n) - монета
cola (n) - кола
cold (adj & n) - холодный
collar (n) - воротник
colleague (n) - коллега
collect (v) - собирать
collection (n) - коллекция
college (n) - колледж
colour (n & v) - цвет
colourful (adj) - красочный
comb (n & v) - расческа
come (v) - приди
comedy (n) - комедия
come on (phr v) - давай
comfort (n) - комфорт
comfortable (adj) - удобный
comic (adj & n) - комический
comma (n) - запятая
comment (n) - комментарий
common (adj) - общий (пр
communicate (v) - общаться
communication (n) - общение
company (n) - компания
compare (v) - сравнить
compete (v) - соревноваться
competition (n) - конкуренция
competitor (n) - конкурент
complain (v) - жаловаться
complaint (n) - жалоба
complete (adj & v) - полный
completely (adv) - полностью
complicated (adj) - сложный
composition (n) - состав
computer (n) - компьютер
concentrate (v) - концентрат
concert (n) - концерт
conclusion (n) - вывод
condition (n) - условие
conference (n) - конференция
confident (adj) - уверенный
confirm (v) - подтвердить
confused (adj) - сбитый с толку
confusing (adj) - сбивающий с толку
congratulations! (exclaim) - поздравляю
connect (v) - соединить
connection (n) - соединение
consider (v) - рассмотреть
consist (v) - состоять
consonant (n) - согласный
contact (n & v) - контакт
contain (v) - содержать
contents (n) - содержание
contest (n) - конкурс
continent (n) - континент
continue (v) - продолжать
contract (n) - контракт
control (n & v) - контроль
convenient (adj) - удобный
conversation (n) - разговор
convince (v) - убедить
cook (n & v) - готовить
cooker (n) - плита
cookie (n) - печенье
cooking (n) - готовить
cool (adj, exclam & v) - круто
copy (n & v) - копировать
corn (n) - кукуруза
corner (n) - угол
correct (adj) - правильный
correction (n) - коррекция
cost (n & v) - стоимость
costume (n) - костюм
cosy (adj) - уютный
cottage (n) - коттедж
cotton (n) - хлопок
cough (n & v) - кашель
could (mv) - мог бы
count (v) - считать
country (n) - страна
countryside (n) - сельская местность
couple (n) - пара
courage (n) - храбрость
course (n) - курс
court (n) - суд
cousin (n) - двоюродный брат
cover (n & v) - обложка
cow (n) - корова
crash (n & v) - сбой
crazy (adj) - сумасшедший
cream (adj & n) - крем
create (v) - создать
creative (adj) - творческий
creature (n) - существо
credit (n) - кредит
credit card (n) - кредитная карта
crew (n) - экипаж
cricket (n) - крикет
crime (n) - преступление
criminal (n) - преступник
crop (n) - урожай
cross (n & v) - крест
crossing (n) - пересечение
cross out (phr v) - вычеркнуть
crossroads (n) - перекресток
crowd (n) - толпа
crowded (adj) - многолюдный
cruel (adj) - жестокий
cruise (n) - круиз
cry (n & v) - плакать
cucumber (n) - огурец
cultural (adj) - культурный
culture (n) - культура
cup (n) - чашка
cupboard (n) - шкаф
cure (n & v) - лечение
curious (adj) - любопытный
curiously (adv) - любопытно
curly (adj) - кудрявый
currency (n) - валюта
curriculum (n) - учебная программа
curry (n) - карри
curtain (n) - занавес
cushion (n) - подушка
custom (n) - обычай
customer (n) - клиент
customs (n pl) - таможня
cut (n & v) - вырезать
cute (adj) - милый
cut up (phr v) - разрезать
CV (n) - Резюме
cycle (n & v) - цикл
cycling (n) - езда на велосипеде
cyclist (n) - велосипедист
dad (n) - папа
daily (adj & adv) - ежедневно
damage (n & v) - ущерб
damaged (adj) - поврежденный
dance (n & v) - танец
dancer (n) - танцор
dancing (n) - танцы
danger (n) - опасность
dangerous (adj) - опасный
dark (adj & n) - темный
data (n) - данные
date (n & v) - дата
daughter (n) - дочь
day (n) - день
dead (adj) - мертвый
deaf (adj) - глухой
deal (v) - сделка
deal with smt (phr v) - иметь дело с smt
dear (adj & exclam) - дорогой
death (n) - смерть
decide (v) - решить
decision (n) - решение
declare (v) - заявить
decorate (v) - украшать
decrease (n & v) - уменьшение
deep (adj & adv) - глубокий
defeat (n & v) - поражение
defence (n) - защита
defend (v) - защищать
definitely (adv) - определенно
degree (n) - степень
delay (n & v) - задержка
delete (v) - удалить
delicious (adj) - вкусный
delighted (adj) - в восторге
deliver (v) - доставить
delivery (n) - доставка
demand (n & v) - спрос
dentist (n) - дантист
depart (v) - уйти
department (n) - отдел
department store (n) - универмаг
departure (n) - отъезд
depend on (v & phr v) - зависит от
deposit (n) - депозит
depressed (adj) - подавленный
depth (n) - глубина
describe (v) - описать
description (n) - описание
desert (n) - пустыня
deserve (v) - заслуживать
design (n & v) - дизайн
designer (n) - дизайнер
desk (n) - стол
despite (prep) - несмотря на
dessert (n) - десерт
destination (n) - пункт назначения
destroy (v) - уничтожить
detail (n) - деталь
detective (n) - детектив
develop (v) - развивать
development (n) - развитие
diagram (n) - диаграмма
dial (v) - набрать
diary (n) - дневник
dictionary (n) - словарь
die (v) - умереть
diet (n) - диета
difference (n) - разница
different (adj) - другой
difficult (adj) - трудный
difficulty (n) - сложность
dig (v) - копать
digital (adj) - цифровой
digital camera (n) - цифровая камера
dining room (n) - столовая
dinner (n) - ужин
dinosaur (n) - динозавр
diploma (n) - диплом
direct (adj & v) - прямой
direction (n) - направление
directly (adv) - прямо
director (n) - директор
dirt (n) - грязь
dirty (adj) - грязный
disabled (adj) - отключен
disadvantage (n) - недостаток
disagree (v) - не согласен
disappear (v) - исчезнуть
disappoint (v) - разочаровать
disappointed (adj) - разочарованный
disappointing (adj) - разочаровывающий
disappointment (n) - разочарование
disc/disk (n) - диск/диск
disc jockey (n) - диск-жокей
disco (n) - дискотека
discount (n) - скидка
discover (v) - обнаружить
discovery (n) - открытие
discuss (v) - обсудить
discussion (n) - обсуждение
disease (n) - болезнь
disgusting (adj) - отвратительный
dish (n) - блюдо
dishwasher (n) - посудомоечная машина
disk (n) - диск
dislike (v) - не нравится
display (n & v) - дисплей
distance (n) - расстояние
district (n) - район
disturb (v) - беспокоить
dive (v) - нырять
diver (n) - ныряльщик
divide (v) - делить
diving (n) - дайвинг
DJ (n) - диджей
do (av & v) - делать
doctor / Dr (n) - врач / Доктор
document (n) - документ
documentary (n) - документальный фильм
dog (n) - собака
doll (n) - кукла
dollar (n) - доллар
dolphin (n) - дельфин
donkey (n) - осел
door (n) - дверь
dot (n) - точка
double (adj & det) - двойной
doubt (n & v) - сомнение
down (adv & prep) - вниз
download (n & v) - скачать
downstairs (adj & adv) - внизу
dozen (det & n) - дюжина
Dr (n) - Доктор
drag (v) - перетащить
drama (n) - драма
draw (v) - рисовать
drawer (n) - ящик
drawing (n) - рисунок
dream (n & v) - мечта
dress (n & v) - платье
dressed (adj) - одетый
drive (n & v) - диск
driver (n) - водитель
driving licence (n) - водительские права
drop (n & v) - падение
drugstore (n) - аптека
drum (n) - барабан
dry (adj & v) - сухой
duck (n) - утка
due (adj) - причитающийся
due to (prep phr) - из-за
dull (adj) - скучный
during (prep) - во время
dust (n) - пыль
dustbin (n) - мусорный ящик
dusty (adj) - пыльный
duty (n) - обязанность
duty-free (adj & n) - беспошлинный
duvet (n) - пуховое одеяло
DVD (n) - DVD
DVD player (n) - DVD-плеер
each (det & pron) - каждый
ear (n) - зарабатыв
earache (n) - боль в ухе
early (adj & adv) - рано
earn (v) - зарабатывать
earring (n) - серьга
earth (n) - земля
east (adj, adv & n) - восток
eastern (adj) - восточный
easily (adv) - легко
easy (adj) - легкий
easygoing (adj) - спокойный
eat (v) - есть
economics (n) - экономика
edge (n) - край
education (n) - образование
effect (n) - эффект
efficient (adj) - эффективный
effort (n) - усилие
egg (n) - яйцо
either (adv, det & pron) - либо
elbow (n) - локоть
elder (adj) - старший
elderly (adj) - пожилой
election (n) - выборы
electric (adj) - электрический
electrical (adj) - электрический
electricity (n) - электричество
electronic (adj) - электронный
elementary (adj) - элементарный
elephant (n) - слон
elevator (n) - лифт
else (adv) - еще
email (n & v) - электронная почта
embarrassed (adj) - смущенный
embarrassing (adj) - смущающий
embassy (n) - посольство
emergency (n) - чрезвычайная ситуация
employ (v) - нанимать
employee (n) - сотрудник
employer (n) - работодатель
employment (n) - занятость
empty (adj) - пустой
encourage (v) - поощрять
end (n & v) - конец
ending (n) - окончание
end up (phr v) - в конечном итоге
enemy (n) - враг
energy (n) - энергия
engaged (adj) - помолвленный
engine (n) - двигатель
engineer (n) - инженер
engineering (n) - инженерное дело
enjoy (v) - наслаждаться
enjoyable (adj) - приятный
enormous (adj) - огромный
enough (adv,det & pron) - достаточно
enquire (v) - спрашивать
enquiry (n) - запрос
enter (v) - введите
entertain (v) - развлекать
entertainment (n) - развлечение
entrance (n) - вход
entry (n) - запись
envelope (n) - конверт
environment (n) - окружающая среда
environmental (adj) - экологический
equal (adj) - равный
equipment (n) - оборудование
eraser (n) - ластик
escape (v) - побег
especially (adv) - особенно
essay (n) - эссе
essential (adj) - существенный
euro (n) - евро
even (adv) - даже
evening (n) - вечер
event (n) - событие
even though (conj) - хотя
ever (adv) - когда-либо
every (det) - каждый
everybody (pron) - все
everyone (pron) - все
everything (pron) - всё
everywhere (adv) - повсюду
exact (adj) - точный
exactly (adv) - точно
examination/exam (n) - экзамен/экзамен
examiner (n) - экзаменатор
example (n) - пример
excellent (adj) - превосходный
except (prep, conj) - кроме
exchange (n) - обменивать
exchange (v) - обмен
exchange rate (n) - обменный курс
excited (adj) - взволнованный
excitement (n) - волнение
exciting (adj) - захватывающий
excuse (n & v) - извини
exercise (n & v) - упражнение
exhausted (adj) - измученный
exhibition (n) - выставка
exist (v) - существовать
exit (n) - выход
expect (v) - ожидать
expedition (n) - экспедиция
expensive (adj) - дорогой
experience (n & v) - опыт
experienced (adj) - опытный
experiment (n) - эксперимент
expert (n) - эксперт
explain (v) - объяснить
explanation (n) - объяснение
explode (v) - взорваться
explore (v) - исследовать
explorer (n) - исследователь
extra (adj, adv & n) - дополнительный
extraordinary (adj) - необыкновенный
extremely (adv) - чрезвычайно
extreme sport (n) - экстремальный вид спорта
eye (n) - глаз
face (n) - лицо
face-to-face (adj) - лицом к лицу
facilities (n pl) - удобства
fact (n) - факт
factory (n) - завод
fail (v) - потерпеть неудачу
fair (adj & n) - ярмарка
fairly (adv) - справедливо
fall (n & v) - падение
false (adj) - ложный
familiar with (adj) - знакомый
family (n) - семья
famous (adj) - знаменитый
fan (n) - веер
fancy (v) - фантазия
fantastic (adj) - фантастический
far (adv) - далеко
fare (n) - тариф
farm (n) - ферма
farmer (n) - фермер
farming (n) - сельское хозяйство
fashion (n) - мода
fashionable (adj) - модный
fast (adj & adv) - быстрый
fasten (v) - закрепить
fast food (n) - фаст-фуд
fat (adj) - толстый
father (n) - отец
fault (n) - ошибка
favour (n) - благосклонность
favourite (adj & n) - любимый
fax (v) - факс
fear (n) - страх
fee (n) - плата
feed (v) - кормить
feel (v) - чувствовать
feeling (n) - чувство
feel like (v) - чувствовать себя как
female (adj & n) - женщина
ferry (n) - паром
festival (n) - фестиваль
fetch (v) - принести
fever (n) - лихорадка
few (adj, det & pron) - несколько
fiction (n) - фантастика
field (n) - поле
fight (n & v) - сражаться
figure (n) - цифра
file (n) - файл
fill in (phr v) - заполнить
fill up (phr v) - наполниться
film (n & v) - фильм
film maker (n) - кинорежиссер
final (adj & n) - окончательный
finally (adv) - наконец
financial (adj) - финансовый
find (v) - найти
find out (phr v) - узнать
fine (adj & n) - хорошо
finger (n) - палец
finish (n & v) - закончить
fire (n) - огонь
firefighter (n) - пожарный
firework (n) - фейерверк
firm (n) - фирма
first (adj & adv) - первый
first name (n) - имя
fish (n & v) - рыба
fishing (n) - рыбалка
fit (adj & v) - подходить
fitness (n) - фитнес
fix (v) - исправить
flag (n) - флаг
flat (adj & n) - плоский
flavour (n) - вкус
flight (n) - полет
float (v) - плавать
flood (n & v) - наводнение
floor (n) - этаж
flour (n) - мука
flow (v) - поток
flower (n) - цветок
flu (n) - грипп
flute (n) - флейта
fly (n & v) - летать
focus (sth) on/upon sth/sb (v) - сосредоточиться
fog (n) - туман
foggy (adj) - туманный
fold (v) - сложить
folder (computer)(n) - папка
folk (adj & n) - народный
follow (v) - следовать
following (adj) - следующий
fond (adj) - любящий
food (n) - еда
fool (n) - дурак
foot (n) - ступня
football (n) - футбол
footballer (n) - футболист
for (prep) - для
forbidden (adj) - запрещенный
forecast (n) - прогноз
foreign (adj) - иностранный
foreigner (n) - иностранец
forest (n) - лес
forever (adv) - навсегда
forget (v) - забыть
forgive (v) - прости
fork (n) - вилка
form (n) - форма
former (adj) - бывший
fortnight (n) - две недели
fortunately (adv) - к счастью
forward (adv) - вперед
fountain (n) - фонтан
frame (n) - рамка
free (adj & adv) - бесплатно
freeze (v) - заморозить
freezer (n) - морозильник
freezing (adj) - замораживание
French fries (n) - Картошка фри
frequent (adj) - частый
frequently (adv) - часто
fresh (adj) - свежий
fridge (n) - холодильник
fried (adj) - жареный
friend (n) - друг
friendly (adj) - дружелюбный
friendship (n) - дружба
frighten (v) - пугать
frightened (adj) - испуганный
frightening (adj) - пугающий
frog (n) - лягушка
from (prep) - из (подгото
front (adj & n) - передний
frozen (adj) - замороженный
fruit (n) - фрукты
fry (v) - жарить
frying pan (n) - сковорода
fuel (n) - топливо
full (adj) - полный
full stop (n) - точка
full time (adv) - полный рабочий день
full- time (adj) - полный рабочий день
fully (adv) - полностью
fun (adj & n) - веселье
funny (adj) - забавный
fur (n) - мех
furniture (n) - мебель
further (adv & adj) - дальше
furthest (adj) - самый дальний
future (adj & n) - будущее
gain (v) - выигрыш
gallery (n) - галерея
game (n) - игра
gap (n) - разрыв
garage (n) - гараж
garden (n) - сад
garlic (n) - чеснок
gas (n) - газ
gas station (n) - заправочная станция
gate (n) - ворота
general (adj) - общий
generally (adv) - вообще
generation (n) - поколение
generous (adj) - щедрый
gentle (adj) - нежный
geography (n) - география
get (v) - получить
get along (with) (phr v) - ладить
get back (phr v) - вернуться
get down (phr v) - спускайся
get fit (v) - привести себя в форму
get in (phr v) - заходи
get off (phr v) - выйти
get on (phr v) - давай
get on (phr v) - давай
get rid of (phr v) - Избавиться
get up (phr v) - вставать
giant (adj) - гигант
gift (n) - подарок
giraffe (n) - жираф
girl (n) - девочка
girlfriend (n) - подруга
give (v) - дать
give back (phr v) - отдать
give in (phr v) - сдаться
give out (phr v) - раздать
give up (phr v) - сдаваться
give way (phr v) - уступить дорогу
glad (adj) - рад
glance (v) - взгляд
glass (n & adj) - стекло
glasses (n pl) - очки
global warming (n) - глобальное потепление
glove (n) - перчатка
go (v & n) - иди
goal (n) - цель
goalkeeper (n) - вратарь
goat (n) - коза
go for (phr v) - идти зa
gold (adj & n) - золото
golden (adj) - золотой
golf (n) - гольф
good (adj) - хороший
good afternoon (exclam) - добрый день
goodbye (exclam) - до свидания
good evening (exclam) - добрый вечер
good-looking (adj) - красивый
good morning (exclam) - доброе утро
good night (exclam) - спокойной ночи
goods (n pl) - товары
go off (phr v) - уходи
go on (phr v) - продолжай
go out (phr v) - выйти
gorgeous (adj) - великолепный
government (n) - правительство
go together (phr v) - идти вместе
grab (v) - схватить
grade (n) - сорт
graduation (n) - выпускной
gram (n) - грамм
grammar (n) - грамматика
grandchild (n) - внук
grand(d)ad (n) - великий (д) ад
granddaughter (n) - внучка
grandfather (n) - дедушка
grandma (n) - бабушка
grandmother (n) - бабушка
grandpa (n) - дедушка
grandparent (n) - дедушка и бабушка
grandson (n) - внук
granny (n) - бабушка
grant (n) - грант
Australia. (n) - Австралия.
grape (n) - виноград
graphics (n pl) - графика
grass (n) - трава
grateful (adj) - благодарный
great (adj) - отличный
green (adj & n) - зеленый
greet (v) - приветствовать
greeting (n) - приветствие
grey (adj & n) - серый
grill (n & v) - гриль
grilled (adj) - жареный
grocery store (n) - продуктовый магазин
groom (n) - жених
ground (n) - земля
group (n) - группа
grow (v) - расти
grow up (phr v) - взрослеть
guard (n) - охранник
guess (n & v) - угадай
guest (n) - гость
guest-house (n) - гостевой дом
guide (n & v) - руководство
guidebook (n) - путеводитель
guilty (adj) - виновный
guitar (n) - гитара
guitarist (n) - гитарист
gum (n) - резинка
gun (n) - пистолет
guy (n) - парень
gym (n) - тренажерный зал
gymnastics (n) - гимнастика
habit (n) - привычка
hair (n) - волосы
haircut (n) - стрижка
hairdresser (n) - парикмахер
hairdryer (n) - фен
half (adv, det, n & pron) - половина
half-price (adj) - полцены
hall (n) - зал
hand (n & v) - рука
handbag (n) - сумочка
hand-held (adj) - ручной
hand in (phr v) - подать руку
handkerchief (n) - носовой платок
handle (v) - ручка
hand out (phr v) - раздавать
handsome (adj) - красивый
handwriting (n) - почерк
hang (v) - повесить
hang out (phr v) - тусоваться
hang up (phr v) - повесь трубку
happen (v) - случиться
happy (adj) - счастливый
happily (adv) - счастливо
happiness (n) - счастье
harbour (n) - гавань
hard (adj & adv) - жесткий
hardly (adv) - едва ли
hardware (n) - аппаратное обеспечение
hat (n) - шляпа
hate (v) - ненавидеть
have (av & v) - есть
have got to (mv) - надо
have to (mv) - придется
he (pron) - он
head (n) - голова
headache (n) - головная боль
headline (n) - заголовок
headphones (n) - наушники
headteacher (n) - директор школы
health (n) - здоровье
healthy (adj) - здоровый
hear (v) - услышать
heart (n) - сердце
heat (n) - тепло
heater (n) - обогреватель
heating (n) - отопление
heavy (adj) - тяжелый
heel (n) - пятка
height (n) - высота
helicopter (n) - вертолет
hello (exclam) - здравствуйте
helmet (n) - шлем
help (n & v) - помогите
her (det & pron) - она
herb (n) - трава
here (adv) - здесь
hero (n) - герой
heroine (n) - героиня
hers (pron) - ее
herself (pron) - сама
hey (exclam) - эй
hi (exclam) - привет
hidden (adj) - скрытый
hide (v) - спрятать
high (adj & adv) - высокий
hike (v) - поход
hill (n) - холм
him (pron) - он
himself (pron) - сам
hip hop (n) - хип-хоп
hire (v & n) - нанять
his (det & pron) - его
historic (adj) - исторический
historical (adj) - исторический
history (n) - история
hit (n & v) - ударить
hitchhike (v) - автостоп
hobby (n) - хобби
hockey (n) - хоккей
hold (v) - держать
hold up (phr v) - подожди
hole (n) - отверстие
holiday (n) - праздник
home (adv & n) - дом
homepage (n) - домашняя страница
homework (n) - домашнее задание
honest (adj) - честный
honestly (adv) - честно
honey (n) - мед
honeymoon (n) - медовый месяц
hope (n & v) - надежда
hopeful (adj) - обнадеживающий
hopefully (adv) - надеюсь
hopeless (adj) - безнадежный
horrible (adj) - ужасный
horror (adj) - ужас
horse (n) - лошадь
hospital (n) - больница
hostel (n) - общежитие
hot (adj) - горячий
hotel (n) - отель
hour (n) - час
house (n) - дом
housewife (n) - домохозяйка
housework (n) - работа по дому
how (adv) - как
however (adv) - однако
how much (adv) - сколько
hug (n & v) - обнять
huge (adj) - огромный
human (adj & n) - человек
humid (adj) - влажный
hunger (n) - голод
hungry (adj) - голодный
hunt (v) - охота
hurry (n & v) - спешить
hurt (adj & v) - больно
husband (n) - муж
hut (n) - хижина
I (pron) - Я
ice (n) - лед
ice cream (n) - мороженое
ice hockey (n) - хоккей с шайбой
ice skates (n) - коньки
ice skating (n) - катание на коньках
icy (adj) - ледяной
ID (n) - Идентификатор
ID card (n) - ID-карта
idea (n) - идея
identification (n) - идентификация
identify (v) - идентифицировать
identity card (n) - удостоверение личности
if (conj) - если
ignore (v) - игнорировать
ill (adj) - больной
illness (n) - болезнь
imagination (n) - воображение
imagine (v) - представить
immediately (adv) - немедленно
immigration (n) - иммиграция
importance (n) - важность
important (adj) - важный
impossible (adj) - невозможно
impressed by (adj) - впечатленный
improve (v) - улучшить
improvement (n) - улучшение
in (adv & prep) - в
in advance (prep phr) - заранее
in case (adv & conj) - на всякий случай
inch (n) - дюйм
include (v) - включать
including (prep) - в том числе
incorrect (adj) - неправильный
increase (v) - увеличение
incredible (adj) - невероятный
incredibly (adv) - невероятно
indeed (adv) - действительно
independent (adj) - независимый
individual (adj) - индивидуальный
indoor (adj) - крытый
indoors (adv) - в помещении
industry (n) - промышленность
in fact (prep phr) - на самом деле
influence (n & v) - влияние
inform (v) - сообщить
information (n) - информация
in front of (prep phr) - перед
ingredient (n) - ингредиент
in half (prep phr) - пополам
in ink (prep phr) - чернилами
initial (n) - начальный
injure (v) - ранить
ink (n) - чернила
in love (prep phr) - влюблён
in pencil (prep phr) - карандашом
in order (prep phr) - по порядку
in order to (prep phr) - чтобы
inquiry (n) - запрос
insect (n) - насекомое
inside (adv & prep) - внутри
insist (v) - настаивать
inspire (v) - вдохновлять
install (v) - установить
instance (n) - экземпляр
instead (adv) - вместо этого
instructions (n pl) - инструкции
instructor (n) - инструктор
instrument (n) - инструмент
intelligent (adj) - умный
intend (v) - намереваться
interest (n & v) - проценты
interested (adj) - заинтересованный
interesting (adj) - интересный
intermediate (adj) - промежуточный
international (adj) - международный
internet (n) - Интернет
interrupt (v) - прерывание
interval (n) - интервал
interview (n & v) - интервью
in the end (prep phr) - в конце
in time (prep phr) - вовремя
into (prep) - в
introduce (v) - представить
introduction (n) - введение
in two (prep phr) - через два
invent (v) - изобретать
invention (n) - изобретение
invitation (n) - приглашение
invite (v) - пригласить
involve (v) - вовлекать
iron (n & v) - железо
ironing (n) - глажка
island (n) - остров
issue (n) - выпуск
IT (n) - ИТ
it (pron) - это
item (n) - предмет
its (det) - это
itself (pron) - сам
jacket (n) - куртка
jail (n) - тюрьма
jam (n) - варенье
jar (n) - банка
jazz (n) - джаз
jealous (adj) - ревнивый
jeans (n pl) - джинсы
jet (n) - струя
jewellery (n) - украшения
job (n) - работа
jog (v) - пробежка
jogging (n) - бег трусцой
join (v) - присоединиться
joke (n & v) - шутка
journalist (n) - журналист
journey (n) - путешествие
judge (n & v) - судья
jug (n) - кувшин
juice (n) - сок
jump (n & v) - прыжок
jumper (n) - джемпер
jungle (n) - джунгли
just (adv) - просто
kangaroo (n) - кенгуру
keen (adj) - острый
keep (v) - держать
keeper (n) - хранитель
keep in (phr v) - оставайся
keep on (phr v) - продолжай
keep up (phr v) - не отставать
kettle (n) - чайник
key (n) - ключ
keyboard (n) - клавиатура
kick (n & v) - удар
kid (n) - малыш
kill (v) - убить
kilogramme (n) - килограмм
kilometre (n) - километр
kind (adj & n) - добрый
king (n) - король
kiss (n & v) - поцелуй
kit (n) - комплект
kitchen (n) - кухня
kite (n) - воздушный змей
kitten (n) - котенок
knee (n) - колено
knife (n) - нож
knit (v) - вязать
knock (v) - стучать
knock down (phr v) - сбить с ног
know (v) - знать
knowledge (n) - знание
label (n) - этикетка
laboratory (n) - лаборатория
lack (n) - недостаток
ladder (n) - лестница
lady (n) - леди
lake (n) - озеро
lamb (n) - ягненок
lamp (n) - лампа
land (n & v) - земля
landscape (n) - пейзаж
language (n) - язык
laptop (n) - ноутбук
large (adj) - большой
last (adj, adv, det & v) - последний
late (adj & adv) - поздно
lately (adv) - в последнее время
later (adj & adv) - позже
latest (adj) - последний
laugh (n & v)  -  смеяться
law (n) - лужай
lawyer (n) - адвокат
lay (v) - лежать
lazy (adj) - ленивый
lead (v) - свинец
leader (n) - лидер
leaf (n) - лист
league (n) - лига
learn (v) - учиться
least (adj & adv) - наименьший
leather (n) - кожа
leave (v) - уйти
lecture (n) - лекция
left (n, adj & adv) - влево
left-hand (adj) - левша
leg (n) - нога
leisure (n) - досуг
lemon (n) - лимон
lemonade (n) - лимонад
lend (v) - одолжить
length (n) - длина
less (adv, det & pron меньше
lesson (n) - урок
let (v) - пусть
letter (n) - буква
lettuce (n) - салат
level (n) - уровень
library (n) - библиотека
licence (n) - лицензия
lie (n & v) - ложь
lie down (phr v) - лечь
life (n) - жизнь
lift (n & v) - подъемник
light (adj, n & v) - свет
lighter (n) - зажигалка
lightning (n) - молния
like (prep & v) - нравится
likely (adj) - вероятный
limit (n & v) - лимит
limited (adj) - ограниченный
line (n) - шер
link (n) - ссылка
lion (n) - лев
lip (n) - губа
liquid (n) - жидкость
list (n) - список
listen (v) - слушай
literature (n) - литература
litre (n) - литр
litter (n) - помет
little (adj, det & pron) - маленький
live (v) - жить
live (adj) - жить
lively (adj) - оживленный
living room (n) - гостиная
load (n) - нагрузка
loan (n) - кредит
local (adj) - местный
locate (v) - найти
location (n) - местоположение
lock (n & v) - замок
locker (n) - шкафчик
logo (n) - логотип
lonely (adj) - одинокий
long (adj) - длинный
look (n & v) - посмотри
look after (phr v) - заботиться
look at (phr v) - посмотри
look for (phr v) - искать
look forward to (phr v) - с нетерпением жду
look like (v) - выглядеть
look out (phr v) - берегись
look up (phr v) - посмотреть вверх
loose (adj) - свободный
lorry (n) - грузовая машина
lose (v) - проиграть
lost (adj) - потерянный
lots / a lot (n) - много/много
lottery (n) - лотерея
loud (adj) - громкий
loudly (adv) - громко
love (n & v) - любовь
lovely (adj) - прекрасный
low (adj) - низкий
luck (n) - удача
luckily (adv) - к счастью
lucky (adj) - удачливый
luggage (n) - багаж
lunch (n) - обед
lunchtime (n) - обеденный перерыв
luxury (n) - роскошь
machine (n) - машин
mad (adj) - безумный
Madam (n) - Госпожа
made of/from/out of (v) - сделанный из/из/из
magazine (n) - журнал
magic (adj & n) - магия
magnificent (adj) - великолепный
mail (n & v) - почта
main (adj) - главный
main course (n) - основное блюдо
make (v) - сделать
make sure (v) - убедиться
make-up (n) - макияж
male (adj & n) - мужской
mall (n) - торговый центр
man (n) - мужчина
manage (v) - управлять
manager (n) - менеджер
mango (n) - манго
many (det & pron) - много
map (n) - карт
mark (n) - знак
market (n) - рынок
marriage (n) - брак
married (adj) - женат
marry (v) - жениться
marvellous (adj) - чудесный
match (n & v) - совпадение
mate (n) - приятель
material (n) - материал
maths / mathematics (n) - математика/математи
matter (n & v) - материя
maximum (adj & n) - максимум
may (mv) - май
maybe (adv) - может быть
me (pron) - я
meal (n) - еда
mean (v) - среднее
meaning (n) - значение
meanwhile (adv) - тем временем
measure (v) - мера
meat (n) - мясо
mechanic (n) - механик
medicine (n) - лекарство
medium (adj) - средний
meet (v) - встретиться
meeting (n) - встреча
melon (n) - дыня
member (n) - член
membership (n) - членство
memory (n) - память
mend (v) - починить
mention (v) - упомянуть
menu (n) - меню
mess (n) - беспорядок
message (n) - сообщение
messy (adj) - беспорядочный
metal (n) - металл
method (n) - метод
metre (n) - метр
microwave (n) - микроволновая печь
midday (n) - полдень
middle (n) - средний
middle-aged (adj) - среднего возраста
midnight (n) - полночь
might (mv) - может
mild (adj) - мягкий
mile (n) - миля
milk (n) - молоко
millimetre (n) - миллиметр
million (n) - миллион
mind (n & v) - разум
mine (pron) - мой
mineral water (n) - минеральная вода
minimum (adj & n) - минимум
minus (prep) - минус
minute (n) - минута
mirror (n) - зеркало
miserable (adj) - несчастный
miss (v) - пропустить
Miss (n) - Мисс
missing (adj) - отсутствует
mistake (n) - ошибка
mix (v & n) - смешать
mobile (n) - мобильный
model (n) - модель
model. (n) - модель
modern (adj) - современный
moment (n) - момент
money (n) - деньги
monkey (n) - обезьяна
monster (n) - монстр
month (n) - месяц
monument (n) - памятник
mood (n) - настроени
moon (n) - луна
more (adv, det & pron) - больше
morning (n) - утро
mosquito (n) - комар
most (adv, det & pron) - большинство
mostly (adv) - в основном
mother (n) - мать
motorbike (n) - мотоцикл
motorcycle (n) - мотоцикл
motor-racing (n) - автоспорт
motorway (n) - автомагистраль
mountain (n) - гора
mouse (n) - мышь
moustache (n) - усы
mouth (n) - рот
move (v) - двигаться
movie (n) - фильм
movie star (n) - кинозвезда
movie theater (n) - кинотеатр
MP3 player (n) - MP3-плеер
Mr (n) - Господ
Mrs (n) - Госпожа
Ms (n) - Госпожа
much (adv, det & pron) - многое
mug (n) - кружка
mum (n) - мама
museum (n) - музей
mushroom (n) - гриб
music (n) - музыка
musical (adj) - музыкальный
musician (n) - музыкант
must (mv) - должен
multiply (v) - умножить
my (det) - мой
myself (pron) - сам
mystery (n) - тайна
name (n & v) - имя
narrow (adj) - узкий
nasty (adj) - противный
national (adj) - национальный
nationality (n) - национальность
natural (adj) - естественный
nature (n) - природа
navy blue (adj) - темно-синий
near (adv, prep & adj) - рядом
nearby (adj & adv) - поблизости
nearly (adv) - почти
neat (adj) - аккуратный
necessary (adj) - необходимый
neck (n) - шея
necklace (n) - ожерелье
need (v) - нуждаться
negative (adj) - отрицательный
neighbour (n) - сосед
neighbourhood (n) - окрестности
neither (adv, det, pron) -  ни
nephew (n) - племянник
nervous (adj) - нервный
nest (n) - гнездо
net (n) - чистая
network (n) - сеть
never (adv) - никогда
new (adj) - новый
news (n) - новости
newspaper (n) - газета
next (adj & adv) - следующий
next to (prep) - рядом с
nice (adj) - приятный
niece (n) - племянница
night (n) - ночь
nightclub (n) - ночной клуб
nightlife (n) - ночная жизнь
nightmare (n) - кошмар
no (adv, det & pron) - нет
nobody (pron) - никто
noise (n) - шу
noisy (adj) - шумный
none (pron) - нет
noon (n) - полдень
no one (pron) - никто
normal (adj) - нормальный
normally (adv) - обычно
north (adj, adv & n) - север
northeast (adj & n) - северо-восток
northern (adj) - северный
northwest (adj & n) - северо-запад
nose (n) - нос
not (adv) - нет
note (n & v) - примечание
notebook (n) - тетрадь
notepaper (n) - бумага для записей
nothing (pron) - ничего
notice (n & v) - уведомление
noticeboard (n) - доска объявлений
novel (n) - роман
now (adv) - сейчас
nowadays (adv) - в наши дни
nowhere (adv) - нигде
number (n) - число
nurse (n) - медсестра
object (n) - предмет
obvious (adj) - очевидный
obviously (adv) - очевидно
occasion (n) - случай
occasionally (adv) - изредка
occupation (n) - род занятий
ocean (n) - океан
o’clock (adv) - час
of (prep) - из
of course (adv) - конечно
off (adv & prep) - выключено
offer (n & v) - предложение
office (n) - офис
officer (n) - офицер
often (adv) - часто
oh (exclam) - ох
oh dear! (exclam) - о, Боже!
oil (n) - масло
OK / O.K. / okay (adj & exclam) - ЛАДНО ЛАДНО. / окей
old (adj) - старый
old-fashioned (adj) - старомодный
olive (n) - оливковое
omelette (n) - омлет
on (adv & prep) - включено
on board (prep phr) - на борту
on business (prep phr) - по делу
once (adv) - однажды
one (det & pron) - один
on fire (prep phr) - в огне
on foot (prep phr) - пешком
on holiday (prep phr) - в отпуске
onion (n) - лук
online (adv & adj) - онлайн
only (adj & adv) - только
on purpose (prep phr) - нарочно
on request (prep phr) - по запросу
on sale (prep phr) - в продаже
on time (prep phr) - вовремя
onto (prep) - на
open (adj & v) - открытый
opening hours (n pl) - часы работы
opera (n) - опера
operate (v) - действовать
operation (n) - операци
opinion (n) - мнение
opportunity (n) - возможность
opposite (adj, n, prep & adv) - напротив
option (n) - вариант
or (conj) - или
orange (adj & n) - оранжевый
orchestra (n) - оркестр
order (conj, n & v) - порядок
ordinary (adj) - обычный
organisation (n) - организация
organise (v) - организовать
original (adj) - оригинальный
other (adj, pron & det) - другое
otherwise (adv) - иначе
ought (mv) - должно
our (det) - наш
ours (pron) - наш
ourselves (pron) - мы сами
out (adv) - выход
outdoor (adj) - открытый
outdoors (adv) - на открытом воздухе
out of (prep) - вне
out of date (prep phr) - устаревший
out of order (prep phr) - вышел из строя
out of work (prep phr) - без работы
outside (adv, adj & prep) - снаружи
oven (n) - печь
over (adv & prep) - окончено
of the school. (prep) - школы
overnight (adj & adv) - ночь
owe (v) - должен
own (adj, pron & v) - собственный
owner (n) - владелец
pack (v) - пачка
packet (n) - пакет
page (n) - страница
pain (n) - боль
painful (adj) - болезненный
paint (n & v) - краска
painter (n) - художник
painting (n) - живопись
pair (n) - пар
palace (n) - дворец
pale (adj) - бледный
pants (n) - штаны
paper (n) - бумаг
paragraph (n) - пункт
parcel (n) - посылка
pardon (exclam) - прощать
parent (n) - родитель
park (n & v) - парк
parking (n) - парковка
parking lot (n) - парковка
parrot (n) - попугай
part (n) - част
partly (adv) - частично
particular (adj) - особый
particularly (adv) - особенно
partner (n) - партнер
part time (adv) - неполный рабочий день
part-time (adj) - неполный рабочий день
party (n) - вечеринка
pass (n & v) - пройти
pass on (phr v) - пройти дальше
passenger (n) - пассажир
passport (n) - паспорт
password (n) - пароль
past (adj, n & prep) - прошлое
pasta (n) - макароны
path (n) - путь
patient (adj & n)  - пациент
pattern (n) - узо
pause (v) - пауза
pavement (n) - тротуар
pay (n & v) - платить
PC (n) - ПК
pea (n) - горох
peace (n) - мир
peaceful (adj) - мирный
peach (n) - персик
peak (n) - пик
peanut (n) - арахис
pear (n) - груша
pedestrian (n) - пешеход
peel (v) - кожура
pen (n) - ручка
pence (n pl) - пенсы
pencil (n) - карандаш
pencil case (n) - пенал
penfriend (n) - друг по переписке
penguin (n) - пингвин
penny (n) - копейка
people (n pl) - люди
pepper (n) - перец
per (prep) - за
percent (adv) - процент
perfect (adj) - идеальный
perfectly (adv) - совершенно
perform (v) - исполнять
performance (n) - производительность
performer (n) - исполнитель
perfume (n) - духи
perhaps (adv) - возможно
period (n) - период
permanent (adj) - постоянный
permission (n) - разрешение
permit (v) - разрешение
permitted (adj) - разрешено
person (n) - человек
personal (adj) - личный
personally (adv) - лично
persuade (v) - уговорить
pet (n) - домашнее животное
petrol (n) - бензин
petrol station (n) - АЗС
pharmacy (n) - аптека
phone (n & v) - телефон
photo (n) - фото
photocopy (n) - фотокопия
photograph (n & v) - фотография
photographer (n) - фотограф
photography (n) - фотография
phrase (n) - фраза
physics (n) - физика
piano (n) - фортепиано
pick (v) - подобрать
pick up (phr v) - забрать
picnic (n) - пикник
picture (n) - картинка
pie (n) - пирог
piece (n) - штука
pig (n) - свинья
pile (n) - ворс
pill (n) - таблетка
pillow (n) - подушка
pilot (n) - пилот
pin (n & v) - штифт
pineapple (n) - ананас
pink (adj & n) - розовый
pipe (n) - труб
pirate (n) - пират
pitch (n) - шаг
pity (n) - жаль
pizza (n) - пицца
place (n) - мест
plain (adj) - простой
plan (n & v) - план
plane (n) - плоскость
planet (n) - планета
plant (n & v) - растение
plastic (adj & n) - пластик
plate (n) - пластин
platform (n) - платформ
play (n & v) - играть
player (n) - игрок
playground (n) - детская площадка
pleasant (adj) - приятный
please (exclam & v) - пожалуйста
pleased (adj) - доволен
pleasure (n) - удовольствие
plenty (pron) - много
plug (n) - вилк
plus (prep & conj) - плюс
p.m. (adv) - вечера.
pocket (n) - карман
pocket money (n) - карманные деньги
podcast (n) - подкаст
poem (n) - стихотворение
poet (n) - поэт
poetry (n) - поэзия
point (n & v) - точка
police (n) - полиция
policeman (n) - полицейский
police officer (n) - полицейский
police station (n) - полицейский участок
polite (adj) - вежливый
political (adj) - политический
politician (n) - политик
politics (n) - политика
pollution (n) - загрязнение
pool (n) - бассейн
poor (adj) - бедный
pop (n) - поп
popular (adj) - популярный
population (n) - население
port (n) - порт
position (n) - позиция
positive (adj) - положительный
possibility (n) - возможность
possible (adj) - возможный
possibly (adv) - возможно
post (n & v) - пост
postcard (n) - открытка
poster (n) - плакат
postman (n) - почтальон
post office (n) - почтовое отделение
postpone (v) - отложить
pot (n) - горшок
potato (n) - картофель
pound (n) - фунт
pour (v) - налить
powder (n) - порошо
power (n) - мощность
powerful (adj) - мощный
practice (n) - практика
practise (v) - практика
pray (v) - молиться
prayer (n) - молитва
predict (v) - предсказать
prefer (v) - предпочитаю
pregnant (adj) - беременная
preparation (n) - подготовка
prepare (v) - готовить
prepared (adj) - подготовленный
prescription (n) - рецепт
present (adj & n & v) - настоящее время
prizes. (v) - призы.
presentation (n) - презентация
presenter (n) - ведущий
president (n) - президент
press (v) - нажмите
pretty (adj & adv) - симпатичный
prevent (v) - предотвратить
previous (adj) - предыдущий
previously (adv) - ранее
price (n) - цена
primary school (n) - начальная школа
prince (n) - князь
princess (n) - принцесса
principal (adj) - главный
print (v) - распечатать
printer (n) - принтер
prison (n) - тюрьма
prisoner (n) - заключенный
private (adj) - частный
prize (n) - приз
probably (adv) - вероятно
problem (n) - проблема
produce (v) - производить
product (n) - продукт
production (n) - производство
profession (n) - профессия
professional (n) - профессиональный
professor (n) - профессор
program (n) - программ
progress (n) - прогресс
prohibited (adj) - запрещено
project (n) - проект
promise (n & v) - обещание
promote (v) - продвигать
pronounce (v) - произнести
pronunciation (n) - произношение
proper (adj) - надлежащий
properly(adv) - правильно
property (n) - свойство
protect (v) - защищать
proud (adj) - гордый
prove (v) - доказать
provide (v) - предоставить
public (adj & n) - общественный
public transport (n) - общественный транспорт
publish (v) - опубликовать
pull (v) - тянуть
pullover (n) - пуловер
pump (n) - насо
punish (v) - наказать
pupil (n) - ученик
puppy (n) - щенок
pure (adj) - чистый
purple (adj & n) - фиолетовый
purpose (n) - цель
purse (n) - кошелек
push (n & v) - нажать
put (v) - поставить
put away (phr v) - убрать
put down (phr v) - положить
put off (phr v) - отложить
put on (phr v) - надеть
put out (phr v) - потушить
put through (phr v) - пройти через
put up (phr v) - ставить
puzzle (n) - головоломка
pyjamas (n pl) - пижама
qualification (n) - квалификация
qualified (adj) - квалифицированный
quality (n) - качество
quantity (n) - количество
quarter (n) - четверть
queen (n) - королева
question (n) - вопро
questionnaire (n) - анкета
queue (n) - очередь
quick (adj) - быстрый
quickly (adv) - быстро
quiet (adj) - тихий
quietly (adv) - тихо
quit (v) - бросить
quite (adv) - вполне
quiz (n) - викторина
rabbit (n) - кролик
race (n & v) - раса
racket (n) - ракетка
rail (n) - рельс
rain (n & v) - дождь
raincoat (n) - плащ
rainforest (n) - тропический лес
raise (v) - поднять
range (n) - диапазон
rap (n) - рэп
rare (adj) - редкий
rarely (adv) - редко
rather (adv) - скорее
raw (adj) - сырой
reach (v) - дотянуться
react (v) - реагировать
read (v) - читат
reader (n) - читатель
reading (n) - чтени
ready (adj) - готов
real (adj) - настоящий
realise (v) - осознать
realistic (adj) - реалистичный
reality (n) - реальность
really (adv) - действительно
reason (n) - причин
reasonable (adj) - разумный
reasonably (adv) - разумно
rebuild (v) - перестроить
receipt (n) - квитанция
receive (v) - получить
recent (adj) - недавний
reception (n) - прие
receptionist (n) - регистратор
recipe (n) - рецеп
recognise (v) - признат
recommend (v) - рекомендовать
record (n & v) - запись
recording (n) - запис
recover (v) - выздоравливать
recycle (v) - перерабатывать
recycled (adj) - переработанный
recycling (n) - переработка
red (adj) - красный
reduce (v) - уменьшить
refreshments (n pl) - прохладительные напитки
refrigerator (n) - холодильник
refund (n) - возврат
refuse (v) - отказаться
regarding (prep) - относительно
regards (n) - С уважением
region (n) - регион
register (v) - зарегистрироваться
registration (n) - регистрация
regret (n & v) - сожаление
regular (adj) - обычный
regularly (adv) - регулярно
relation (n) - отношение
relationship (n) - отношения
relative (n) - относительный
relax (v) - расслабиться
relaxation (n) - расслабление
relaxed (adj) - расслабленный
reliable (adj) - надежный
relieved (adj) - с облегчением
religion (n) - религия
rely (v) - полагатьс
remain (v) - оставатьс
remember (v) - помни
remind (v) - напомнит
remote control (n) - пульт дистанционного управления
remove (v) - удалить
rent (n & v) - аренда
repair (n & v) - ремонт
repeat (v) - повторить
replace (v) - заменить
reply (n & v) - ответ
report (n & v) - отчет
reporter (n) - репортер
request (n & v) - запрос
require (v) - требовать
rescue (n & v) - спасение
research (n & v) - исследования
reservation (n) - оговорка
reserve (n & v) - резерв
resort (n) - курорт
respect (n & v) - уважение
responsible (adj) - ответственный
rest (n & v) - отдых
restaurant (n) - ресторан
result (n) - результат
retire (v) - выйти на пенсию
return (n & v) - возврат
review (n) - обзор
revise (v) - пересмотреть
revision (n) - редакция
reward (n) - награда
rice (n) - рис
rich (adj) - богатый
ride (n & v) - ездить
rider (n) - всадник
right (adj, adv & n) - вправо
right-hand (adj) - правая рука
ring (n & v) - кольцо
ring back (phr v) - перезвоните
ring up (phr v) - позвони
rise (v) - подъем
river (n) - река
road (n) - дорог
roast (adj & v) - жаркое
rob (v) - грабить
robot (n) - робот
rock (n) - рок
rocket (n) - ракета
role (n) - рол
roll (n) - перекат
romance (n) - романтика
romantic (adj) - романтический
roof (n) - крыш
room (n) - комната
rope (n) - веревка
rose (n) - роза
rough (adj) - грубый
round (adj, adv & prep) - раунд
roundabout (n) - кольцевой
route (n) - маршрут
routine (n) - рутина
row (n) - ря
rubber (n) - резина
rubbish (n) - мусор
rude (adj) - грубый
rug (n) - коврик
rugby (n) - регби
ruin (n) - разорение
rule (n & v) - правило
ruler (n) - правитель
run (v) - бежать
runner (n) - бегун
running (n) - бег
run out (phr v) - кончиться
sad (adj) - грустный
safe (adj) - безопасный
safely (adv) - безопасно
sail (n & v) - парус
sailing (n) - парусный спорт
salad (n) - салат
salary (n) - зарплата
sale (n) - продажа
salesman/saleswoman (n) - продавец/продавщица
salmon (n) - лосось
salt (n) - сол
same (adj, pron & adv) - тот же
sand (n) - песок
sandal (n) - сандалия
sandwich (n) - бутерброд
satisfactory (adj) - удовлетворительный
satisfied (adj) - удовлетворенный
sauce (n) - соу
saucepan (n) - кастрюля
saucer (n) - блюдце
sausage (n) - колбаса
save (v) - сохранить
say (v) - скажи
scared (adj) - испуганный
scarf (n) - шарф
scary (adj) - страшный
scene (n) - сцена
scenery (n) - пейзаж
school (n) - школа
schoolchild (n) - школьник
science (n) - наука
science fiction (n) - научная фантастика
scientific (adj) - научный
scientist (n) - ученый
scissors (n pl) - ножницы
scooter (n) - самокат
score (n & v) - оценка
scream (n & v) - кричать
screen (n) - экран
sculpture (n) - скульптура
sea (n) - море
search (n & v) - поиск
seaside (n) - приморский
season (n) - сезон
seat (n) - сиденье
seat belt (n) - ремень безопасности
second (adv, det & n) - второй
late (det) - поздно
secondary (adj) - вторичный
second-hand (adj & adv) - подержанный
secret (adj & n) - секрет
secretary (n) - секретарь
section (n) - раздел
security (n) - безопасность
see (v) - видеть
(consult) - проконсультируйт
seem (v) - показаться
select (v) - выбрать
selfie (n) - селфи
selfish (adj) - эгоистичный
self-service (adj) - самообслуживание
sell (v) - продать
send (v) - отправить
sense (n) - смысл
sensible (adj) - разумный
sentence (n) - предложение
separate (adj) - отдельный
series (n) - серия
serious (adj) - серьезный
seriously (adv) - серьёзно
serve (v) - подавать
server (n) - сервер
service (n) - услуга
session (n) - сеанс
set off (phr v) - отправиться в путь
set out (phr v) - выдвигаться
set up (phr v) - настроить
several (det & pron) - несколько
sew (v) - шит
sex (n) - пол
shade (n) - оттенок
shadow (n) - тень
shake (v) - встряхнуть
shall (mv) - должен
shame (n) - стыд
shampoo (n) - шампунь
shape (n) - форма
share (v) - доля
shark (n) - акула
sharp (adj) - острый
shave (v) - бриться
she (pron) - она
sheep (n) - овца
sheet (n) - лис
shelf (n) - полк
shine (v) - сиять
shiny (adj) - блестящий
ship (n) - корабль
shirt (n) - рубашка
shock (n) - шок
shocked (adj) - шокированный
shocking (adj) - шокирующий
shoe (n) - туфелька
shoot (v) - стрелять
shop (n & v) - магазин
shop assistant (n) - продавец
shopping (n) - шоппинг
shore (n) - берег
short (adj) - короткий
shortly (adv) - вскоре
shorts (n pl) - шорты
should (mv) - должен
shoulder (n) - плечо
shout (n & v) - крикнуть
show (n & v) - показать
show up (phr v) - появиться
shower (n) - душ
shut (adj & v) - закрыть
shy (adj) - застенчивый
sick (adj) - больной
side (n) - сторона
sight (n) - прице
sightseeing (n) - осмотр достопримечательностей
sign (n & v) - знак
signal (n & v) - сигнал
signature (n) - подпись
signpost (n) - указатель
sign up (v) - зарегистрироваться
silence (n) - тишина
silent (adj) - тихий
silk (adj & n) - шелк
silly (adj) - глупый
silver (adj & n) - серебро
similar (adj) - подобный
simple (adj) - простой
since (conj & prep) - поскольку
sincerely (adv) - искренне
singer (n) - певец
singing (n) - пение
single (n & adj) - одиночный
sink (n & v) - раковина
sir (n) - сэр
sister (n) - сестра
sit (v) - сидеть
sit down (phr v) - садись
site (n) - сайт
sitting room (n) - гостиная
situated (adj) - расположенный
situation (n) - ситуаци
size (n) - размер
skate (n & v) - кататься на коньках
skateboard (n & v) - скейтборд
skateboarding (n) - катание на скейтборде
skating (n) - катание на коньках
ski (n & v) - лыжи
skiing (n) - катание на лыжах
skill (n) - умение
skin (n) - кожа
skirt (n) - юбка
sky (n) - небо
sleep (n & v) - спать
sleeve (n) - рука
slice (n) - кусочек
slightly (adv) - слегка
slim (adj) - стройный
slip (v) - скольжение
slowly (adv) - медленно
small (adj) - маленький
smart (adj) - умный
smartphone (n) - смартфон
smell (n & v) - запах
smile (n & v) - улыбка
smoke (n & v) - курить
smoking (n) - курить
smooth (adj) - гладкий
snack (n) - закусит
snake (n) - змея
snow (n & v) - снег
snowboard (n & v) - сноуборд
snowboarding (n) - катание на сноуборде
so (adv & conj) - итак
soap (n) - мыло
soap opera (n) - мыльная опера
soccer (n) - футбол
sociable (adj) - общительный
social (adj) - социальный
social media (n) - социальные сети
society (n) - общество
sock (n) - носок
sofa (n) - диван
soft (adj) - мягкий
software (n) - программное обеспечение
soldier (n) - солдат
solution (n) - раствор
solve (n) - решить
some (det & pron) - некоторые
somebody (pron) - кто-то
somehow (adv) - как-то
someone (pron) - кто-то
something (pron) - что-то
sometimes (adv) - иногда
somewhere (adv) - где-то
son (n) - сын
song (n) - песня
soon (adv) - скоро
sore (adj) - боль
sorry (adj) - извини
sort (n) - сортировать
so-so (adj) - так себе
soul (n) - душа
sound (n & v) - звук
soundtrack (n) - саундтрек
soup (n) - суп
sour (adj) - кислый
south (adj & adv, n) - юг
southeast (adj & n) - юго-восток
southern (adj) - южный
southwest (adj & n) - юго-запад
souvenir (n) - сувенир
space (n) - пробел
spaceship (n) - космический корабль
spare (adj & v) - запасной
sparkling (adj) - сверкающий
speak (v) - говорить
speaker (n) - говорящий
special (adj) - особенный
specially (adv) - специально
species (n) - вид
spectacular (adj) - захватывающий
speech (n) - реч
speed (n) - скорость
spell (v) - заклинание
spelling (n) - написание
spend (v) - тратить
spice (n) - пряность
spicy (adj) - пряный
spill (v) - разлив
spinach (n) - шпинат
spite (n) - назло
split up (phr v) - расстаться
spoil (v) - портить
spoon (n) - ложк
sport (n) - спорт
sports centre (n) - спортивный центр
spot (n) - пятно
spy (n) - шпион
square (adj & n) - квадрат
squash (n) - тыква
stadium (n) - стадион
staff (n) - персонал
stage (n) - этап
stairs (n pl) - лестница
stall (n) - ларек
stamp (n) - штамп
stand (v) - стоят
star (n) - звезда
start (n & v) - начать
a good start (n) - хорошее начало
to start a race (v) - начать гонку
station (n) - станция
statue (n) - статуя
stay (n & v) - остаться
stay behind (phr v) - остаться
steak (n) - стейк
steal (v) - украсть
steep (adj) - крутой
step (n) - шаг
step forward (v) - шаг вперед
step over (v) - переступить
stick (n & v) - палка
sticky (adj) - липкий
still (adj & adv) - все еще
stir (v) - перемешать
stomach (n) - желудок
stomach ache (n) - болит живот
stone (n) - камень
stop (n & v) - стоп
store (n) - магази
storm (n) - гроза
story (n) - рассказ
straight (adj & adv) - прямой
strange (adj) - странный
stranger (n) - незнакомец
strawberry (n) - клубника
stream (n) - ручей
street (n) - улица
stress (n) - стресс
stressed (adj) - подчеркнутый
stressful (adj) - стрессовый
strict (adj) - строгий
strike (n & v) - забастовка
stripe (n) - полоса
strong (adj) - сильный
student (n) - студент
studio (n) - студия
study (n & v) - исследование
stuff (n) - вещи
stupid (adj) - глупый
style (n) - стиль
stylish (adj) - стильный
subject (n) - предмет
subtract (v) - вычесть
subway (n) - метро
succeed (v) - добиться успеха
success (n) - успех
successful (adj) - успешный
such (det) - такой
sudden (adj) - внезапный
suddenly (adv) - внезапно
suffer (v) - страдат
sugar (n) - сахар
suggest (v) - предложить
suggestion (n) - предложение
suit (n & v) - костюм
suitable (adj) - подходящий
suitcase (n) - чемодан
sum (n) - сумма
sun (n) - солнце
sunbathe (v) - загорать
sunglasses (n pl) - солнцезащитные очки
sunny (adj) - солнечный
sunrise (n) - восход солнца
sunset (n) - закат
sunshine (n) - солнечный свет
superhero (n) - супергерой
supermarket (n) - супермаркет
supper (n) - ужин
supply (v) - поставка
party (n) - вечеринка
support (n & v) - поддержка
exams. (n) - Экзамены
supporter (n) - сторонник
suppose (v) - предположим
sure (adj & adv) - уверен
surf (v) - прибой
surfboard (n) - доска для серфинга
surfing (n) - серфинг
surname (n) - фамилия
surprise (n & v) - сюрприз
surprised (adj) - удивленный
suprising (adj) - удивительный
surround (v) - окружить
sweater (n) - свитер
sweatshirt (n) - толстовка
sweet (adj & n) - сладкий
swim (n & v) - плавать
swimmer (n) - пловец
swimming (n) - плавание
swimming costume (n) - купальный костюм
swimming pool (n) - бассейн
swimsuit (n) - купальник
switch (n & v) - переключатель
system (n) - система
table (n) - таблиц
table-cloth (n) - скатерть
tablet (n) - таблетка
table tennis (n) - настольный теннис
take (v) - взять
takeaway (n) - еда на вынос
take away (v) - забрать
take care of (v) - заботиться о
take off (phr v) - взлетать
take part (v) - принять участи
take place (v) - состоятьс
take up (phr v) - взять
talent (n) - талант
talented (adj) - талантливый
talk (n & v) - поговорить
talk show (n) - ток-шоу
tall (adj) - высокий
tap (n) - коснуться
taste (n & v) - вкус
tasty (adj) - вкусный
tax (n) - налог
taxi (n) - такси
tea (n) - чай
teach (v) - учить
teacher (n) - учитель
teaching (n) - учение
team (n) - команда
tear (n & v) - слеза
technique (n) - техник
technology (n) - технологи
teenager (n) - подросток
telephone (n & v) - телефон
television (n) - телевидение
tell (v) - скажи
temperature (n) - температура
air temperature (n) - температура воздуха
temporary (adj) - временный
tennis (n) - теннис
tense (n) - напряженное
tent (n) - палатка
term (n) - термин
terrible (adj) - ужасный
terribly (adv) - ужасно
terrific (adj) - потрясающий
terrified (adj) - испуганный
test (n & v) - тест
text (n & v) - текст
textbook (n) - учебник
text message (n) - текстовое сообщение
than (conj & prep) - чем
thank (v) - благодарить
thanks (exclam) - спасибо
thank you (exclam) - спасибо
that (conj, det & pron) - что
theatre (n) - театр
their (det) - их
theirs (pron) - их
them (pron) - их
themselves (pron) - сами
then (adv) - тогда
there (adv) - там
therefore (adv) - следовательно
these (det & pron) - эти
they (pron) - они
thick (adj) - толстый
thief (n) - вор
thin (adj) - тонкий
thing (n) - вещь
think (v) - думать
thirsty (adj) - жаждущий
this (det & pron) - это
those (det & pron) - те
though (conj) - хотя
thought (n) - мысл
thriller (n) - триллер
throat (n) - горло
through (prep) - через
throw (v) - бросить
throw away (phr v) - выбросить
thumb (n) - большой палец
thunder (n) - гром
thunderstorm (n) - гроза
tick (n & v) - поставить галочку
ticket (n) - билет
tidy (adj & v) - аккуратный
tidy up (phr v) - наводить порядок
tie (n & v) - галстук
tiger (n) - тигр
tight (adj) - тугой
tights (n pl) - колготки
till (conj & prep) - до
time (n & v) - время
timetable (n) - расписание
tin (n) - олово
tiny (adj) - крошечный
tip (n) - наконечник
tip (n) - наконечник
tired (adj) - усталый
tiring (adj) - утомительный
tissue (n) - ткан
title (n) - титул
to (prep) - чтобы
toast (n) - тост
today (adv & n) - сегодня
toe (n) - носок
together (adv) - вместе
toilet (n) - туалет
tomato (n) - помидор
tomorrow (adv & n) - завтра
tongue (n) - язык
tonight (adv & n) - сегодня вечером
too (adv) - тоже
tooth/teeth (n) - зуб/зубы
toothache (n) - зубная боль
toothbrush (n) - зубная щетка
toothpaste (n) - зубная паста
top (adj & n) - верх
topic (n) - тема
torch (n) - факел
total (adj & n) - всего
totally (adv) - совсем
touch (v) - коснуться
tour (n & v) - тур
tour guide (n) - экскурсовод
tourism (n) - туризм
tourist (n) - турист
tourist information centre (n) - туристско-информационный центр
tournament (n) - турнир
toward (prep) - навстречу
towel (n) - полотенце
tower (n) - башня
town (n) - город
toy (n) - игрушка
track (n) - дорожк
tracksuit (n) - спортивный костюм
trade (n) - торговля
traditional (adj) - традиционный
traffic (n) - трафик
traffic jam (n) - пробка
traffic light (n) - светофор
train (n & v) - поезд
trainer (n) - тренер
training (n) - обучение
tram (n) - трамвай
transfer (v) - трансфер
translate (v) - перевести
translation (n) - перевод
transport (n) - транспорт
trash can (n) - мусорное ведро
travel (v) - путешествие
travel agent (n) - турагент
tree (n) - дерево
trend (n) - тренд
trick (n) - трюк
trip (n) - путешествие
trouble (n) - бед
trousers (n pl) - брюки
truck (Am Eng) - грузовик
trunk (n) - ствол
true (adj) - истинный
trumpet (n) - труба
trust (v) - доверие
truth (n) - правда
try (v) - попробуй
try on (phr v) - примерить
T-shirt (n) - Футболка
tube (n) - трубк
tuna (n) - тунец
tune (n) - мелодия
tunnel (n) - туннель
turkey (n) - индейка
turn (n & v) - повернуть
turn down (phr v) - выключиться
turning (n) - поворо
turn into (phr v) - превратиться в
turn off (phr v) - выключи
turn on (phr v) - включи
turn up (phr v) - поднимись
twice (adv) - дважды
twin (n) - близнец
type (n & v) - тип
typical (adj) - типичный
typically (adv) - обычно
tyre (n) - покрышка
ugly (adj) - уродливый
umbrella (n) - зонт
unable (adj) - неспособный
unbelievable (adj) - невероятный
uncle (n) - дядя
uncomfortable (adj) - неудобный
under (prep) - под (подготовитель
underground (adj & n) - подземный
underline (v) - подчеркнуть
underneath (prep) - внизу
underpants (n) - трусы
understand (v) - понять
underwear (n) - нижнее белье
undress (v) - раздетьс
unemployed (adj) - безработный
unemployment (n) - безработица
unexpected (adj) - неожиданный
unfair (adj) - несправедливый
unfit (adj) - непригодный
unforgettable (adj) - незабываемый
unfortunately (adv) - к сожалению
unfriendly (adj) - недружелюбный
unhappy (n) - несчастный
unhealthy (adj) - нездоровый
uniform (n) - униформа
union (n) - союз
unit (n) - единица
unkind (adj) - недобрый
unknown (adj) - неизвестный
unimportant (adj) - неважный
uninterested (adj) - незаинтересованный
uninteresting (adj) - неинтересный
universe (n) - вселенная
university (n) - университет
unless (conj) - если только
unlikely (adj) - маловероятно
unlucky (adj) - невезучий
unnecessary (adj) - ненужный
unpack (v) - распаковать
unpleasant (adj) - неприятный
untidy (adj) - неопрятный
until (prep & conj) - пока
unusual (adv) - необычный
unwell (adj) - нездоров
up (adv & prep) - вверх
update (n & v) - обновление
upload (n & v) - загрузить
upon (prep) - по (приготовле
upper (adj) - верхний
upset (adj) - расстраиваться
upstairs (adj & adv) - наверху
up to (prep phr) - до
up to date (prep phr) - в курсе
urgent (adj) - срочный
urgently (adv) - срочно
us (pron) - мы
use (n & v) - использовать
used to (v) - привык
useful (adj) - полезный
user (n) - пользователь
usual (adj) - обычный
usually (adv) - обычно
v/versus (prep) - v/против
valley (n) - долина
valuable (adj) - ценный
value (n) - значение
van (n) - фургон
vanilla (n) - ваниль
variety (n) - сорт
various (adj) - различный
vase (n) - ваза
vegetable (n) - овощной
vegetarian (n & adj) - вегетарианец
vehicle (n) - транспортное средство
version (n) - версия
very (adv) - очень
vet (n) - ветеринар
via (prep) - через
video (n & v) - видео
video clip (n) - видеоклип
video game (n) - видеоигра
view (n) - вид
village (n) - деревня
violin (n) - скрипка
virus (n) - вирус
visa (n) - виза
visit (n & v) - посетить
visitor (n) - посетитель
vocabulary (n) - словарный запас
voice (n) - голос
volleyball (n) - волейбол
volume (n) - объем
volunteer (n) - доброволец
vote (n & v) - голосовать
vowel (n) - гласная
wage (n) - заработная плата
wait (n & v) - подожди
waiter (n) - официан
waiting room (n) - зал ожидания
waitress (n) - официантка
wake (v) - просыпаться
wake up (phr v) - просыпайся
walk (n & v) - ходить
walking (n) - идти
wall (n) - стен
wallet (n) - кошелек
want (v) - хочу
war (n) - предупрежд
wardrobe (n) - шкаф
warm (adj) - теплый
warn (v) - предупредит
warning (n) - предупреждение
wash (n & v) - мыть
wash up (phr v) - мыться
washing machine (n) - стиральная машина
washing-up (n) - мытье посуды
waste (adj & v) - отходы
watch (n & v) - смотреть
water (n & v) - вода
waterfall (n) - водопад
wave (n & v) - волна
way (n) - путь
we (pron) - мы
weak (adj) - слабый
wear (v) - носить
wear out (phr v & adj) - изнашиваться
weather (n) - погод
weather forecast (n) - прогноз погоды
web (n) - паутина
webcam (n) - веб-камера
web page (n) - веб-страница
website (n) - сайт
wedding (n) - свадьба
week (n) - неделя
weekday (n) - будний день
weekend (n) - выходные
weekly (adj & adv) - еженедельно
weigh (v) - весить
weight (n) - вес
welcome (n & v) - добро пожаловать
well (adj, adv & exclam) - ну
well done! (adv) - отличная работа!
well-dressed (adj) - хорошо одетый
well-known (adj) - известный
well made (adv & adj) - хорошо сделано
west (adj, adv & n) - запад
western (adj) - западный
wet (adj) - мокрый
whale (n) - кит
what (det & pron) - что
whatever (pron & det) - что угодно
wheel (n) - колес
wheelchair (n) - инвалидная коляска
when (adv) - когда
whenever (conj) - всякий раз
where (adv & conj) - где
wherever (conj) - где бы то ни было
whether (conj) - ли
which (pron & det) - который
while, whilst (conj) - пока, пока
while (n) - в то время как
white (adj) - белый
who (pron) - кто
whole (adj & n) - целое
whose (det & pron) - чей
why (adv) - почему
wide (adj) - широкий
wife (n) - жена
wild (adj) - дикий
wildlife (n) - живая природа
will (mv) - будет
willing (adj) - желающий
win (v) - победить
wind (n) - ветер
window (n) - окно
windscreen (n) - лобовое стекло
windsurfing (n) - виндсерфинг
windy (n) - ветреный
wing (n) - крыло
winner (n) - победитель
wise (adj) - мудрый
wish (n & v) - пожелать
with (prep) - с
within (prep) - внутри
without (prep) - без
woman (n) - женщина
wonder (v) - удивляться
wonderful (adj) - чудесный
wood (n) - древесина
wool (n) - шерсть
word (n) - слово
work (n & v) - работа
worker (n) - рабочий
working (adj) - работающий
workout (n) - тренировка
work out (phr v) - потренироваться
world (n) - мир
worried (adj) - обеспокоенный
worry (n & v) - волноваться
worse (adj & adv) - хуже
worst (adj & adv) - худший
worth (adj) - стоит
would (mv) - бы
wow (exclam) - вау
wrap up (v & phr v) - подведение итогов
write (v) - напиш
write down (phr v) - запиши
writer (n) - писатель
writing (n) - пиш
written (adj) - письменный
wrong (adj) - неправильный
yard (n) - двор
yeah (exclam) - да
year (n) - год
yellow (adj) - желтый
yes (adv) - да
yesterday (adv) - вчера
yet (adv) - еще
yoga (n) - йога
yogurt (n) - йогурт
you (pron) - ты
you know (exclam) - ты знаешь
young (adj) - молодой
your (det) - твой
yours (pron) - твой
yourself (pron) - себя
youth (n) - молодежь
zebra (n) - зебра
zero (n) - ноль
zone (n) - зона
zoo (n) - зоопарк